111111111111111111111111111111111111
1000000000000000000000000000000000C1
10000000000C000000000000000000000001
1000000000000000000000P0000000000001
100000000000000001000000000000000001
100C0000000000000000000000000C000001
100000000000000000000000000000000001
100000000000000000000C00000000000001
100C0000000000000000000000000000E001
100000000000000000000000000000000001
111111111111111111111111111111111111