111111111111111111111111111111111111
1000000000000000000000011111000000C1
10000000000C000000000000000000000001
1000000000000000000000P0000000000001
100000000000000001000000000000000001
100C0000000000000001111110000C000001
100000000000000010000000000000000001
100000000000000000000C00000000000001
100C0000000000111000000111000000E001
100000000000000010000000010000000001
111111111111111111111111111111111111